F 74,33,4
C 225,30,3

WE ./WeST
EA ./east
SO ./east
NO      ./chemin_vers_un_certain_fichier

        1111111111111111111111111
        1000000000110000000000001
        101100000111000s000000001
        1001000000000000000000001
111111111011000001110000000000001
100000s00011000001110111111111111
11110111111111011100000010001
11110111111111011101010010001
11000000110101011100000010001
1000000000000000110s0000D0001
10000000000000001101010010001
11000001110101011111011110N0111
11110111 1110101 101111010001
11111111 1111111 111111111111



