F 170,170,170
C 50,50,50

WE textures/basalt_top.xpm
EA textures/basalt_top.xpm
SO textures/basalt_top.xpm
NO textures/basalt_top.xpm

1111
1001
10N1
1111