F 170,170,170
C 50,50,50

WE textures/basalt_top.xpm
EA textures/basalt_top.xpm
SO textures/basalt_top.xpm
NO textures/basalt_top.xpm

1111111111111111111111111
1000000011000000111101001
1000000011000000100001001
1000000011000000100101001
1000000011000000100101001
1000000011000000100101001
1000000011000000100101111
1000000011000000100100001
1000000000110000100100101
1000000011000000100100101
1000000110000000100100101
1000000000000000000100101
1000000110000000011110101
10000000110000X0000100001
1000000000110000000100001
1111110111111111111100001
1000000000000001111100001
1000000000000001000000011
100000000000000100000001
100000000000000111110111
100000000000000100000111
10000000000000011100X001
10000X000000000100000001
100000000000000101111111
1000000000X0000100000001
100000000000000100000001
100000000000000100000001
100000000000001100000001
100000000000000111111101
111111111000000100000001
11111110010E000100000001
111111100010001100000001
111111111111111100000001
100000000000000000001111
10000000000000X000000001
111111100000000000000001
111111111111111111111111