F 186,255,201
C 213,186,255

WE ./WeST
EA ./east
SO ./east
NO ./chemin_vers_un_certain_fichier

1111111111111111111111111
1000000011000000111101001
1000000011000000100001001
1000000011000000100101001
1000000011000000100101001
1000000011000000100101001
1000000011000000100101111
1000000011000000100100001
1000000000110000100100101
1000000011000000100100101
1000000110000000100100101
1000000000000000000100101
1000000110000000011110101
1000000011000000000100001
1000000000110000000100001
1111110111111111111100001
1000000000000001111100001
1000000000000001000000011
100000000000000100000001
100000000000000111110111
100000000000000100000111
100000000000000111000001
100000000000000100000001
100000000000000101111111
100000000000000100000001
100000000000000100000001
100000000000000100000001
100000000000001100000001
100000000000000111111101
111111111000000100000001
111111100100000100000001
111111100010001100000001
111111111111111100000001
100000000000000000001111
1000000N0000000000000001
111111100000000000000001
111111111111111111111111