F 170,170,170
C 50,50,50

WE textures/matrix.xpm
EA textures/matrix.xpm
SO textures/matrix.xpm
NO textures/matrix.xpm

1111111111111111111111111
1000000011000000111101001
1000000011000000100001001
1000000011000000100101001
1000000011000000100101001
1000000011000000100101001
1000000011000000100101111
1000000011000000100100001
1000000000110000100100101
1000000011000000100100101
1000000110000000100100101
1000000D00000000000100101
100X000110000000011110101
10000000110000X0000100001
1000000000110000000100001
111111D111111111111100001
100000X000000001111100001
100000000000001000000011
100000000X00000100000001
10000000000000011111D111
100000000000000100000111
10000000000000011100X001
100000000000000100000001
100000000000000101111111
100000000000000100000001
100000000000000100000001
100000000000000100000001
100000000000001100000001
1000000000000001111111D1
111111111000000100000001
11111110010N000100000001
111111100010001100000001
111111111111111100000001
100000000000000000001111
10000000000000X000000001
111111100000000000000001
111111111111111111111111